+-------------------------------------------+
|                                           |
|                 (kitchen)                 |
|                                           |
|                                           |
|          +--------------------------------+
|          |                                |
|          |                                |
|          |           +----------+         |
|          |           |       P  |         |
|          |       W   |          |         |
|          |           |          +------+  |
|          +-----------+               C |  |
|                        +---------------+  |
|                       /   W               |
|                      /                    |
|                     /                     |
|                    +-------------------+  |
|                                        |  |
|                                        |  |
|                    +-------------------+  |
|                    |                      |
|                    |   (sleeping room)    |
|                    |                      |
+--------------------+----------------------+