+-----------+------------------------------------+
|           |                                    |
| (closet)  |                                    |
|           |                                    |
+-----------+                       S            |
            |              (sleeping room)       |
            |                                    |
            +------------------------------------+