+-----------+------------------------------------+
|           |                       3            |
| (closet)  |                       2            |
|           |                       1            |
+-----------+                      6S            |
            |              (sleeping4room)       |
            |                       5            |
            +------------------------------------+