+-----------+------------------------------------+
|           |                                    |
|           |                                    |
|           |                                    |
| (closet)  |              S                     |
|           |                                    |
|           |                                    |
+-----------+                                    |
            |              (sleeping room)       |
            |                                    |
            |                                    |
            +------------------------------------+