+-----------+------------------------------------+
|           |                                    |
|           |                                    |
|           |                                    |
| (closet)  |                                    |
|           |                                    |
|           |      S                             |
+-----------+                                    |
            |              (sleeping room)       |
            |                                    |
            |                                    |
            +------------------------------------+