+-----------+------------------------------------+
|           |                                    |
| (closet)  |    (sleeping room)             3   |
|           |                                2   |
+-----------+                                1   |
            |                                S   |
            |                                    |
            +------------------------------------+