+-----------+------------------------------------+
|           |      2                             |
| (closet)  |      1                             |
|           |      S                             |
+-----------+      3                             |
            |      4       (sleeping room)       |
            |                                    |
            +------------------------------------+